25
8
W W W W W W W W W W W W W W W W W W W W W W W W W
W O O O O O O O O O O O O O O O O O O O O O O O W
W O O O O O O O O O O O O O O O O O O O O O O O W
W O O O O W J1 O O O O O O O O O O O O O O O O O W
W O O O J1 J1 W W J1 W W W W W W W W W W W W W W W W
W P O J1 O O O O O O L1 W W W W W W W W W W W W W W
W U1 U1 U1 U1 U1 U1 U1 U1 U1 U1 U1 U1 U1 U1 U1 U1 U1 U1 U1 U1 U1 U1 U1 W
W W W W W W W W W W W W W W W W W W W W W W W W W