21
7
X X X X X X X X X X X X X X X X X X X X X
X O O O O O O O O O O O O O O O O O O O X
X O O O O O O X O O O O O O O O O O O O X
X O O O O O O WF O O O O O O O O O O O O X
X P G1 E1 O O O X O O O O O O O O O O O O X
X G1 G1 G1 G1 G1 G1 G1 G1 G1 G1 G1 G1 G1 G1 G1 G1 G1 G1 G1 X
X X X X X X X X X X X X X X X X X X X X X