21
7
X X X X X X X X X X X X X X X X X X X X X
X O O O O O O O O O O O O O O O O O O O X
X O O O O O O X O O O O O O O O O O O O X
X O O O O O O O O O O O O O O O O O O O X
X P O O O O O X O O O O O O O O O O O O X
X G1 G1 G1 G1 G1 G1 G1 G1 G1 G1 G1 G1 G1 G1 G1 G1 G1 G1 G1 X
X X X X X X X X X X X X X X X X X X X X X